11111111111111
1CCCCCCCCCCCC1
1CCCCCCPCCCCC1
1CCCCCC0CCCCC1
1CCCCCCCCCCCE1
11111111111111