11111111
10000C01
10000001
1001P001
10C100E1
11111111